FFFFFFFFFFFFFFFFFFFF
8888A22222222222222B
8888A88888888888882B
8888A22222222222222B
8888A88888888888882B
8888A22222222222222B
8888A88888888888882B
8888A22222222222222B
8888A88888888888882B
8888A22222222222222B
8888A22222222222222B
FFFFFFFFFFFFFFFFFFFF