# Mapa grande - diseño complejo
# Combinaciones de paredes: 9=N+W, B=N+E+W, 3=N+E, 6=E+S, C=S+W, A=E+W
9 1 1 1 1 1 1 1 1 1 1 1 1 1 1 3
8 0 0 0 0 0 0 0 0 0 0 0 0 0 0 2
8 0 9 3 0 9 1 1 B 0 9 3 0 0 0 2
8 0 8 2 0 8 0 0 2 0 8 2 0 9 3 2
8 0 C A 0 8 0 0 2 0 C A 0 8 0 2
8 0 0 0 0 8 0 0 2 0 0 0 0 8 0 2
8 0 9 1 1 C 4 4 A 1 1 3 0 8 0 2
8 0 8 0 0 0 0 0 0 0 0 2 0 8 0 2
8 0 8 0 9 1 1 1 1 1 3 2 0 8 0 2
8 0 8 0 8 0 0 0 0 0 2 2 0 8 0 2
8 0 8 0 C 4 4 4 4 4 A 2 0 C 4 A
8 0 C 4 4 4 4 4 4 4 4 A 0 0 0 0
C 4 4 4 4 4 4 4 4 4 4 4 4 4 4 6